,short_name,long_name,predicting_year,PER,continuity,product,num_wins,predicted_wins,error,absError
0,PHO,Phoenix Suns,1992,254.1,0.861875,219.0024375,53,57,-4,4
1,DAL,Dallas Mavericks,1992,211.7,0.693704268,146.8571936,22,47,-25,25
2,BOS,Boston Celtics,1992,211.5,0.837870935,177.2097027,51,51,0,0
3,SAC,Sacramento Kings,1992,204.0,0.404456301,82.50908537,29,38,-9,9
4,CLE,Cleveland Cavaliers,1992,194.3,0.689822154,134.0324446,57,45,12,12
5,MIL,Milwaukee Bucks,1992,192.1,0.757469512,145.5098933,31,47,-16,16
6,DET,Detroit Pistons,1992,186.0,0.739207317,137.492561,48,46,2,2
7,CHI,Chicago Bulls,1992,182.6,0.966946138,176.5643648,67,51,16,16
8,DEN,Denver Nuggets,1992,179.5,0.317560976,57.00219512,24,34,-10,10
9,WSB,Washington Bullets,1992,178.9,0.55745935,99.72947764,25,40,-15,15
10,HOU,Houston Rockets,1992,177.2,0.863252033,152.9682602,42,48,-6,6
11,UTA,Utah Jazz,1992,176.6,0.779212398,137.6089096,55,46,9,9
12,NYK,New York Knicks,1992,175.8,0.670365854,117.8503171,51,43,8,8
13,ATL,Atlanta Hawks,1992,175.4,0.469014228,82.26509553,38,38,0,0
14,GSW,Golden State Warriors,1992,173.3,0.74066565,128.3573572,55,45,10,10
15,MIN,Minnesota Timberwolves,1992,173.2,0.825955285,143.0554553,15,47,-32,32
16,IND,Indiana Pacers,1992,173.1,0.936148374,162.0472835,40,49,-9,9
17,SAS,San Antonio Spurs,1992,173.0,0.802073171,138.7586585,47,46,1,1
18,MIA,Miami Heat,1992,170.2,0.742860772,126.4349035,38,44,-6,6
19,LAL,Los Angeles Lakers,1992,169.1,0.772454268,130.6220168,43,45,-2,2
20,ORL,Orlando Magic,1992,163.2,0.935066057,152.6027805,21,48,-27,27
21,POR,Portland Trail Blazers,1992,161.8,0.936875,151.586375,57,48,9,9
22,CHH,Charlotte Hornets,1992,157.3,0.622662602,97.94482724,31,40,-9,9
23,LAC,Los Angeles Clippers,1992,154.5,0.654496951,101.119779,45,41,4,4
24,PHI,Philadelphia 76ers,1992,153.4,0.576814024,88.48327134,35,39,-4,4
25,NJN,New Jersey Nets,1992,148.6,0.600218496,89.1924685,40,39,1,1
26,SEA,Seattle SuperSonics,1992,143.1,0.600436992,85.92253354,47,38,9,9
27,ATL,Atlanta Hawks,1993,212.2,0.710518293,150.7719817,43,48,-5,5
28,SAS,San Antonio Spurs,1993,208.3,0.588328252,122.5487749,49,44,5,5
29,GSW,Golden State Warriors,1993,201.2,0.784817073,157.9051951,34,49,-15,15
30,PHO,Phoenix Suns,1993,191.3,0.560731707,107.2679756,62,42,20,20
31,BOS,Boston Celtics,1993,185.3,0.82945122,153.697311,48,48,0,0
32,ORL,Orlando Magic,1993,182.2,0.676620935,123.2803343,41,44,-3,3
33,CLE,Cleveland Cavaliers,1993,181.5,0.831158537,150.8552744,54,48,6,6
34,WSB,Washington Bullets,1993,178.7,0.609237805,108.8707957,22,42,-20,20
35,POR,Portland Trail Blazers,1993,177.0,0.800934959,141.7654878,51,46,5,5
36,MIL,Milwaukee Bucks,1993,176.7,0.38675813,68.34016159,28,36,-8,8
37,SEA,Seattle SuperSonics,1993,174.7,0.853333333,149.0773333,55,47,8,8
38,IND,Indiana Pacers,1993,172.0,0.713831301,122.7789837,41,44,-3,3
39,LAL,Los Angeles Lakers,1993,167.5,0.733455285,122.8537602,39,44,-5,5
40,DAL,Dallas Mavericks,1993,167.5,0.536737805,89.90358232,11,39,-28,28
41,NJN,New Jersey Nets,1993,167.0,0.778597561,130.0257927,43,45,-2,2
42,CHH,Charlotte Hornets,1993,166.5,0.810731707,134.9868293,44,45,-1,1
43,LAC,Los Angeles Clippers,1993,164.0,0.599344512,98.2925,41,40,1,1
44,DEN,Denver Nuggets,1993,162.8,0.639329268,104.0828049,36,41,-5,5
45,DET,Detroit Pistons,1993,162.6,0.672240854,109.3063628,40,42,-2,2
46,MIA,Miami Heat,1993,161.7,0.92050813,148.8461646,36,47,-11,11
47,MIN,Minnesota Timberwolves,1993,160.7,0.254893293,40.96135213,19,32,-13,13
48,UTA,Utah Jazz,1993,159.2,0.714314024,113.7187927,47,42,5,5
49,CHI,Chicago Bulls,1993,157.8,0.88390752,139.4806067,57,46,11,11
50,HOU,Houston Rockets,1993,155.3,0.779867886,121.1134827,55,43,12,12
51,PHI,Philadelphia 76ers,1993,148.6,0.713658537,106.0496585,26,41,-15,15
52,SAC,Sacramento Kings,1993,147.7,0.908104675,134.1270605,25,45,-20,20
53,NYK,New York Knicks,1993,125.3,0.573333333,71.83866667,60,36,24,24
54,GSW,Golden State Warriors,1994,226.2,0.638323171,144.3887012,50,47,3,3
55,NJN,New Jersey Nets,1994,209.0,0.422926829,88.39170732,45,39,6,6
56,BOS,Boston Celtics,1994,205.6,0.626356707,128.778939,32,45,-13,13
57,CLE,Cleveland Cavaliers,1994,200.2,0.80765752,161.6930356,47,49,-2,2
58,WSB,Washington Bullets,1994,198.9,0.642322154,127.7578765,24,44,-20,20
59,CHI,Chicago Bulls,1994,193.1,0.663064024,128.0376631,55,44,11,11
60,PHO,Phoenix Suns,1994,193.1,0.790177846,152.583342,56,48,8,8
61,PHI,Philadelphia 76ers,1994,189.3,0.323231707,61.1877622,25,35,-10,10
62,IND,Indiana Pacers,1994,186.6,0.753805894,140.6601799,47,46,1,1
63,MIL,Milwaukee Bucks,1994,185.3,0.571727642,105.9411321,20,41,-21,21
64,ORL,Orlando Magic,1994,183.1,0.862769309,157.9730605,50,49,1,1
65,DAL,Dallas Mavericks,1994,183.1,0.493323171,90.32747256,13,39,-26,26
66,SAC,Sacramento Kings,1994,178.7,0.728597561,130.2003841,28,45,-17,17
67,LAC,Los Angeles Clippers,1994,177.2,0.673887195,119.412811,27,43,-16,16
68,MIA,Miami Heat,1994,176.0,0.959044715,168.7918699,42,50,-8,8
69,UTA,Utah Jazz,1994,172.3,0.649039634,111.829529,53,42,11,11
70,SEA,Seattle SuperSonics,1994,170.1,0.592571138,100.7963506,63,41,22,22
71,SAS,San Antonio Spurs,1994,168.4,0.590523374,99.44413618,55,40,15,15
72,HOU,Houston Rockets,1994,168.1,0.877418699,147.4940833,58,47,11,11
73,NYK,New York Knicks,1994,167.7,0.95620935,160.3563079,57,49,8,8
74,ATL,Atlanta Hawks,1994,167.4,0.741224593,124.080997,57,44,13,13
75,POR,Portland Trail Blazers,1994,166.2,0.801946138,133.2834482,47,45,2,2
76,MIN,Minnesota Timberwolves,1994,162.7,0.743729675,121.0048181,20,43,-23,23
77,LAL,Los Angeles Lakers,1994,162.6,0.644776423,104.8406463,33,41,-8,8
78,DEN,Denver Nuggets,1994,160.5,0.722972561,116.037096,42,43,-1,1
79,CHH,Charlotte Hornets,1994,154.7,0.746824187,115.5337017,41,43,-2,2
80,DET,Detroit Pistons,1994,142.4,0.515289634,73.3772439,20,37,-17,17
81,SEA,Seattle SuperSonics,1995,238.9,0.85824187,205.0339827,57,55,2,2
82,UTA,Utah Jazz,1995,220.6,0.653252033,144.1073984,60,47,13,13
83,IND,Indiana Pacers,1995,208.1,0.84988313,176.8606794,52,51,1,1
84,SAS,San Antonio Spurs,1995,208.0,0.689751016,143.4682114,62,47,15,15
85,PHO,Phoenix Suns,1995,206.4,0.692601626,142.9529756,59,47,12,12
86,CLE,Cleveland Cavaliers,1995,204.2,0.687469512,140.3812744,43,46,-3,3
87,LAL,Los Angeles Lakers,1995,196.3,0.795228659,156.1033857,48,48,0,0
88,HOU,Houston Rockets,1995,190.8,0.734410569,140.1255366,47,46,1,1
89,BOS,Boston Celtics,1995,190.8,0.673932927,128.5864024,35,45,-10,10
90,NYK,New York Knicks,1995,189.4,0.83734248,158.5926657,55,49,6,6
91,WSB,Washington Bullets,1995,188.3,0.597291667,112.4700208,21,42,-21,21
92,ORL,Orlando Magic,1995,184.7,0.791925813,146.2686977,57,47,10,10
93,LAC,Los Angeles Clippers,1995,184.2,0.458414634,84.43997561,17,38,-21,21
94,GSW,Golden State Warriors,1995,182.9,0.48613313,88.91374949,26,39,-13,13
95,DET,Detroit Pistons,1995,182.6,0.460376016,84.06466057,28,38,-10,10
96,CHI,Chicago Bulls,1995,179.2,0.725365854,129.985561,47,45,2,2
97,POR,Portland Trail Blazers,1995,178.6,0.81449187,145.468248,44,47,-3,3
98,ATL,Atlanta Hawks,1995,173.0,0.620284553,107.3092276,42,42,0,0
99,NJN,New Jersey Nets,1995,172.9,0.890904472,154.0373831,30,48,-18,18
100,MIA,Miami Heat,1995,172.4,0.483292683,83.31965854,32,38,-6,6
101,CHH,Charlotte Hornets,1995,172.3,0.800203252,137.8750203,50,46,4,4
102,MIN,Minnesota Timberwolves,1995,172.0,0.650604675,111.9040041,21,42,-21,21
103,DAL,Dallas Mavericks,1995,162.2,0.574283537,93.14878963,36,40,-4,4
104,DEN,Denver Nuggets,1995,154.3,0.98023374,151.2500661,41,48,-7,7
105,PHI,Philadelphia 76ers,1995,145.2,0.522337398,75.84339024,24,37,-13,13
106,SAC,Sacramento Kings,1995,141.0,0.596194106,84.0633689,39,38,1,1
107,MIL,Milwaukee Bucks,1995,137.0,0.505172764,69.2086687,34,36,-2,2
108,DEN,Denver Nuggets,1996,237.0,0.737738821,174.8441006,35,51,-16,16
109,ORL,Orlando Magic,1996,225.4,0.93402439,210.5290976,60,56,4,4
110,PHO,Phoenix Suns,1996,219.1,0.708917683,155.3238643,41,48,-7,7
111,GSW,Golden State Warriors,1996,217.0,0.314644309,68.27781504,36,36,0,0
112,CLE,Cleveland Cavaliers,1996,216.0,0.660889228,142.7520732,47,47,0,0
113,LAL,Los Angeles Lakers,1996,209.2,0.826671748,172.9397297,53,51,2,2
114,CHI,Chicago Bulls,1996,208.3,0.649618902,135.3156174,72,45,27,27
115,LAC,Los Angeles Clippers,1996,196.7,0.743338415,146.2146662,29,47,-18,18
116,BOS,Boston Celtics,1996,192.1,0.594496951,114.2028643,33,43,-10,10
117,IND,Indiana Pacers,1996,189.8,0.77527439,147.1470793,52,47,5,5
118,CHH,Charlotte Hornets,1996,185.4,0.600264228,111.2889878,41,42,-1,1
119,WSB,Washington Bullets,1996,185.1,0.552510163,102.2696311,39,41,-2,2
120,DET,Detroit Pistons,1996,183.9,0.689349593,126.7713902,46,44,2,2
121,PHI,Philadelphia 76ers,1996,180.3,0.294893293,53.16926067,18,34,-16,16
122,UTA,Utah Jazz,1996,175.4,0.808658537,141.8387073,55,46,9,9
123,SEA,Seattle SuperSonics,1996,173.5,0.799817073,138.7682622,64,46,18,18
124,SAS,San Antonio Spurs,1996,170.3,0.677962398,115.4569964,59,43,16,16
125,MIL,Milwaukee Bucks,1996,170.1,0.611239837,103.9718963,25,41,-16,16
126,DAL,Dallas Mavericks,1996,161.7,0.818262195,132.312997,26,45,-19,19
127,POR,Portland Trail Blazers,1996,160.3,0.700843496,112.3452124,44,42,2,2
128,HOU,Houston Rockets,1996,159.4,0.674684959,107.5447825,48,42,6,6
129,NYK,New York Knicks,1996,159.1,0.720132114,114.5730193,47,43,4,4
130,SAC,Sacramento Kings,1996,157.7,0.646478659,101.9496845,39,41,-2,2
131,MIN,Minnesota Timberwolves,1996,151.0,0.254283537,38.39681402,26,32,-6,6
132,MIA,Miami Heat,1996,150.9,0.043445122,6.555868902,42,27,15,15
133,ATL,Atlanta Hawks,1996,150.6,0.430965447,64.90339634,46,36,10,10
134,NJN,New Jersey Nets,1996,145.4,0.408485772,59.3938313,30,35,-5,5
135,WSB,Washington Bullets,1997,304.6,0.535335366,163.0631524,44,49,-5,5
136,HOU,Houston Rockets,1997,232.8,0.382815041,89.11934146,57,39,18,18
137,PHO,Phoenix Suns,1997,217.1,0.418170732,90.78486585,40,39,1,1
138,ORL,Orlando Magic,1997,212.1,0.663297764,140.6854558,45,46,-1,1
139,LAL,Los Angeles Lakers,1997,196.1,0.41210874,80.81452388,56,38,18,18
140,IND,Indiana Pacers,1997,194.6,0.715599593,139.2556809,39,46,-7,7
141,CLE,Cleveland Cavaliers,1997,192.6,0.686143293,132.1511982,42,45,-3,3
142,CHI,Chicago Bulls,1997,185.8,0.979110772,181.9187815,69,52,17,17
143,SEA,Seattle SuperSonics,1997,183.0,0.787942073,144.1933994,57,47,10,10
144,UTA,Utah Jazz,1997,182.6,0.82773374,151.1441809,64,48,16,16
145,LAC,Los Angeles Clippers,1997,169.1,0.855172764,144.6097144,36,47,-11,11
146,POR,Portland Trail Blazers,1997,168.6,0.424527439,71.57532622,49,36,13,13
147,DAL,Dallas Mavericks,1997,165.3,0,0,24,26,-2,2
148,DEN,Denver Nuggets,1997,163.1,0.509639228,83.12215803,21,38,-17,17
149,DET,Detroit Pistons,1997,161.4,0.730848577,117.9589604,54,43,11,11
150,CHH,Charlotte Hornets,1997,160.1,0.429542683,68.76978354,54,36,18,18
151,SAC,Sacramento Kings,1997,159.6,0.77070122,123.0039146,34,44,-10,10
152,ATL,Atlanta Hawks,1997,159.0,0.405030488,64.39984756,56,35,21,21
153,VAN,Vancouver Grizzlies,1997,155.8,0.401295732,62.521875,14,35,-21,21
154,SAS,San Antonio Spurs,1997,152.7,0.73484248,112.2104466,20,42,-22,22
155,PHI,Philadelphia 76ers,1997,151.8,0.319242886,48.46107012,22,33,-11,11
156,BOS,Boston Celtics,1997,150.6,0.775670732,116.8160122,15,43,-28,28
157,TOR,Toronto Raptors,1997,146.8,0.275746951,40.47965244,30,32,-2,2
158,GSW,Golden State Warriors,1997,145.9,0.554115854,80.84550305,30,38,-8,8
159,MIN,Minnesota Timberwolves,1997,129.5,0.558409553,72.31403709,40,37,3,3
160,NJN,New Jersey Nets,1997,120.5,0.18203252,21.9349187,26,29,-3,3
161,NYK,New York Knicks,1997,120.2,0.398338415,47.88027744,57,33,24,24
162,MIL,Milwaukee Bucks,1997,113.2,0.470416667,53.25116667,33,34,-1,1
163,MIA,Miami Heat,1997,101.2,0.332982724,33.69785163,61,31,30,30
164,CHI,Chicago Bulls,1998,215.6,0.882647358,190.2987703,62,53,9,9
165,SEA,Seattle SuperSonics,1998,211.7,0.677876016,143.5063526,61,47,14,14
166,MIA,Miami Heat,1998,209.0,0.678135163,141.730249,55,46,9,9
167,BOS,Boston Celtics,1998,197.5,0.220965447,43.64067581,36,32,4,4
168,HOU,Houston Rockets,1998,197.0,0.852281504,167.8994563,41,50,-9,9
169,LAL,Los Angeles Lakers,1998,195.0,0.719908537,140.3821646,61,46,15,15
170,LAC,Los Angeles Clippers,1998,190.3,0.61886687,117.7703653,17,43,-26,26
171,TOR,Toronto Raptors,1998,188.3,0.449893293,84.71490701,16,38,-22,22
172,PHI,Philadelphia 76ers,1998,188.2,0.44726626,84.17551016,31,38,-7,7
173,SAS,San Antonio Spurs,1998,184.0,0.577042683,106.1758537,56,41,15,15
174,POR,Portland Trail Blazers,1998,178.3,0.367855691,65.58866972,46,36,10,10
175,SAC,Sacramento Kings,1998,174.9,0.624456301,109.217407,27,42,-15,15
176,ORL,Orlando Magic,1998,172.4,0.641814024,110.6487378,41,42,-1,1
177,DET,Detroit Pistons,1998,171.5,0.564679878,96.84259909,37,40,-3,3
178,CLE,Cleveland Cavaliers,1998,166.2,0.314695122,52.30232927,47,34,13,13
179,NYK,New York Knicks,1998,166.1,0.945569106,157.0590285,43,49,-6,6
180,IND,Indiana Pacers,1998,162.4,0.746473577,121.2273089,58,43,15,15
181,UTA,Utah Jazz,1998,162.2,0.978231707,158.6691829,62,49,13,13
182,ATL,Atlanta Hawks,1998,162.2,0.813739837,131.9886016,50,45,5,5
183,VAN,Vancouver Grizzlies,1998,160.2,0.543119919,87.00781098,19,39,-20,20
184,PHO,Phoenix Suns,1998,159.8,0.536707317,85.76582927,56,38,18,18
185,MIN,Minnesota Timberwolves,1998,159.6,0.80125,127.8795,45,44,1,1
186,CHH,Charlotte Hornets,1998,145.5,0.634110772,92.26311738,51,39,12,12
187,GSW,Golden State Warriors,1998,144.8,0.330919715,47.9171748,19,33,-14,14
188,DEN,Denver Nuggets,1998,139.1,0.192621951,26.79371341,11,30,-19,19
189,MIL,Milwaukee Bucks,1998,125.7,0.53296748,66.9940122,36,36,0,0
190,NJN,New Jersey Nets,1998,121.4,0.467261179,56.72550711,43,34,9,9
191,DAL,Dallas Mavericks,1998,59.5,0.069146341,4.114207317,20,27,-7,7
221,DET,Detroit Pistons,2000,253.0,0.42695122,108.0186585,42,42,0,0
222,DEN,Denver Nuggets,2000,250.5,0.406224593,101.7592607,35,41,-6,6
223,POR,Portland Trail Blazers,2000,225.7,0.406387195,91.72158994,59,39,20,20
224,PHO,Phoenix Suns,2000,224.7,0.393556911,88.4322378,53,39,14,14
225,SAS,San Antonio Spurs,2000,213.0,0.584613821,124.5227439,53,44,9,9
226,LAC,Los Angeles Clippers,2000,199.3999999999999,0.314136179,62.63875407,15,35,-20,20
227,SEA,Seattle SuperSonics,2000,199.1,0.201310976,40.08101524,45,32,13,13
228,ATL,Atlanta Hawks,2000,194.0,0.236077236,45.79898374,28,33,-5,5
229,LAL,Los Angeles Lakers,2000,192.7,0.412571138,79.50245833,67,38,29,29
230,SAC,Sacramento Kings,2000,185.4,0.488556911,90.57845122,44,39,5,5
231,NYK,New York Knicks,2000,185.3999999999999,0.601112805,111.446314,50,42,8,8
232,WAS,Washington Wizards,2000,179.5,0.317881098,57.05965701,29,34,-5,5
233,HOU,Houston Rockets,2000,178.1,0.298292683,53.12592683,34,34,0,0
234,MIA,Miami Heat,2000,178.0,0.499954268,88.99185976,52,39,13,13
235,DAL,Dallas Mavericks,2000,177.6,0.49351626,87.6484878,40,39,1,1
236,IND,Indiana Pacers,2000,175.2,0.544405488,95.37984146,56,40,16,16
237,UTA,Utah Jazz,2000,168.5,0.485609756,81.8252439,55,38,17,17
238,VAN,Vancouver Grizzlies,2000,161.9,0.361392276,58.50940955,22,35,-13,13
239,GSW,Golden State Warriors,2000,160.1,0.387063008,61.9687876,19,35,-16,16
240,MIL,Milwaukee Bucks,2000,158.7,0.315172764,50.01791768,42,33,9,9
241,CHI,Chicago Bulls,2000,158.6,0.184913618,29.3272998,17,30,-13,13
242,BOS,Boston Celtics,2000,154.6,0.362083333,55.97808333,35,34,1,1
243,MIN,Minnesota Timberwolves,2000,144.2,0.462830285,66.74012703,50,36,14,14
244,PHI,Philadelphia 76ers,2000,142.6,0.47120935,67.19445325,49,36,13,13
245,CLE,Cleveland Cavaliers,2000,141.1,0.386971545,54.60168496,32,34,-2,2
246,CHH,Charlotte Hornets,2000,120.3,0.321788618,38.71117073,49,32,17,17
247,TOR,Toronto Raptors,2000,114.6,0.555533537,63.66414329,45,35,10,10
248,ORL,Orlando Magic,2000,111.2,0.251107724,27.92317886,41,30,11,11
249,NJN,New Jersey Nets,2000,43.50000000000001,0.321463415,13.98365854,31,28,3,3
250,HOU,Houston Rockets,2001,237.3,0.858191057,203.6487378,45,55,-10,10
251,PHO,Phoenix Suns,2001,217.0,0.661702236,143.5893852,51,47,4,4
252,IND,Indiana Pacers,2001,215.9,0.659476626,142.3810036,41,46,-5,5
253,MIA,Miami Heat,2001,206.2,0.445614837,91.88577947,50,39,11,11
254,NJN,New Jersey Nets,2001,199.9,0.775706301,155.0636895,26,48,-22,22
255,WAS,Washington Wizards,2001,197.8,0.475482724,94.05048272,19,40,-21,21
256,SAS,San Antonio Spurs,2001,197.4,0.792139228,156.3682835,58,48,10,10
257,POR,Portland Trail Blazers,2001,196.8,0.892591463,175.662,50,51,-1,1
258,SAC,Sacramento Kings,2001,188.9,0.833577236,157.4627398,55,49,6,6
259,DAL,Dallas Mavericks,2001,183.6,0.561753049,103.1378598,53,41,12,12
260,SEA,Seattle SuperSonics,2001,182.2,0.744207317,135.5945732,44,46,-2,2
261,LAL,Los Angeles Lakers,2001,181.3,0.733038618,132.8999014,56,45,11,11
262,GSW,Golden State Warriors,2001,178.7,0.437581301,78.19577846,17,37,-20,20
263,VAN,Vancouver Grizzlies,2001,177.7,0.669512195,118.9723171,23,43,-20,20
264,MIN,Minnesota Timberwolves,2001,176.7,0.735513211,129.9651845,47,45,2,2
265,BOS,Boston Celtics,2001,175.2,0.79609248,139.4754024,36,46,-10,10
266,TOR,Toronto Raptors,2001,173.5,0.611204268,106.0439405,47,41,6,6
267,DEN,Denver Nuggets,2001,171.6,0.652469512,111.9637683,40,42,-2,2
268,PHI,Philadelphia 76ers,2001,169.8,0.818734756,139.0211616,56,46,10,10
269,MIL,Milwaukee Bucks,2001,166.2,0.799822154,132.9304421,52,45,7,7
270,ATL,Atlanta Hawks,2001,162.1,0.376122967,60.96953303,25,35,-10,10
271,ORL,Orlando Magic,2001,161.9,0.554903455,89.83886941,43,39,4,4
272,UTA,Utah Jazz,2001,161.3,0.707083333,114.0525417,53,42,11,11
273,CHI,Chicago Bulls,2001,157.9,0.402398374,63.53870325,15,35,-20,20
274,DET,Detroit Pistons,2001,157.5,0.29972561,47.20678354,32,33,-1,1
275,CHH,Charlotte Hornets,2001,155.8,0.523861789,81.61766667,46,38,8,8
276,CLE,Cleveland Cavaliers,2001,153.1,0.39441565,60.38503608,30,35,-5,5
277,NYK,New York Knicks,2001,148.5,0.722977642,107.3621799,48,42,6,6
278,LAC,Los Angeles Clippers,2001,146.0,0.424054878,61.9120122,31,35,-4,4
279,POR,Portland Trail Blazers,2002,234.8000000000001,0.660909553,155.181563,49,48,1,1
280,SAS,San Antonio Spurs,2002,212.8,0.619466463,131.8224634,58,45,13,13
281,LAL,Los Angeles Lakers,2002,209.6,0.724303862,151.8140894,58,48,10,10
282,SEA,Seattle SuperSonics,2002,205.2,0.652982724,133.9920549,45,45,0,0
283,CLE,Cleveland Cavaliers,2002,203.7,0.494629065,100.7559405,29,41,-12,12
284,MIA,Miami Heat,2002,194.0,0.382870935,74.27696138,36,37,-1,1
285,SAC,Sacramento Kings,2002,191.2,0.830574187,158.8057846,61,49,12,12
286,UTA,Utah Jazz,2002,187.9,0.751077236,141.1274126,44,46,-2,2
287,HOU,Houston Rockets,2002,187.7,0.627123984,117.7111717,28,43,-15,15
288,MIL,Milwaukee Bucks,2002,186.7,0.826128049,154.2381067,41,48,-7,7
289,ORL,Orlando Magic,2002,186.7,0.711392276,132.816938,44,45,-1,1
290,NJN,New Jersey Nets,2002,182.8,0.427642276,78.17300813,52,37,15,15
291,BOS,Boston Celtics,2002,180.0,0.745086382,134.1155488,49,45,4,4
292,LAC,Los Angeles Clippers,2002,174.7,0.900797764,157.3693694,39,49,-10,10
293,MIN,Minnesota Timberwolves,2002,172.5,0.785838415,135.5571265,50,46,4,4
294,CHI,Chicago Bulls,2002,168.1,0.292931911,49.24185417,21,33,-12,12
295,GSW,Golden State Warriors,2002,168.1,0.633460366,106.4846875,21,41,-20,20
296,CHH,Charlotte Hornets,2002,167.6,0.812906504,136.2431301,44,46,-2,2
297,DEN,Denver Nuggets,2002,163.9,0.507764228,83.22255691,27,38,-11,11
298,IND,Indiana Pacers,2002,161.9,0.580934959,94.05336992,42,40,2,2
299,DAL,Dallas Mavericks,2002,155.2,0.622327236,96.58518699,57,40,17,17
300,PHI,Philadelphia 76ers,2002,148.9,0.390675813,58.17162856,43,35,8,8
301,PHO,Phoenix Suns,2002,144.9,0.287515244,41.66095884,36,32,4,4
302,DET,Detroit Pistons,2002,143.4,0.618892276,88.74915244,50,39,11,11
303,NYK,New York Knicks,2002,133.7,0.617947154,82.61953455,30,38,-8,8
304,WAS,Washington Wizards,2002,126.4,0.320325203,40.48910569,37,32,5,5
305,ATL,Atlanta Hawks,2002,123.9,0.477804878,59.20002439,33,35,-2,2
306,TOR,Toronto Raptors,2002,109.4,0.558968496,61.15115346,42,35,7,7
307,LAL,Los Angeles Lakers,2003,220.8,0.879796748,194.259122,50,54,-4,4
308,SEA,Seattle SuperSonics,2003,220.5,0.477281504,105.2405716,40,41,-1,1
309,ATL,Atlanta Hawks,2003,213.7,0.606864837,129.6870158,35,45,-10,10
310,DET,Detroit Pistons,2003,213.4,0.753612805,160.8209726,50,49,1,1
311,POR,Portland Trail Blazers,2003,204.5,0.863043699,176.4924365,50,51,-1,1
312,TOR,Toronto Raptors,2003,202.8,0.614222561,124.5643354,24,44,-20,20
313,WAS,Washington Wizards,2003,201.1,0.476534553,95.83109858,37,40,-3,3
314,SAS,San Antonio Spurs,2003,199.9,0.739471545,147.8203618,60,47,13,13
315,PHI,Philadelphia 76ers,2003,196.8,0.426803862,83.995,48,38,10,10
316,LAC,Los Angeles Clippers,2003,191.4,0.675797764,129.3476921,27,45,-18,18
317,SAC,Sacramento Kings,2003,189.9,0.990955285,188.1824085,59,53,6,6
318,MIN,Minnesota Timberwolves,2003,189.3,0.718546748,136.0208994,51,46,5,5
319,ORL,Orlando Magic,2003,188.2,0.607601626,114.350626,42,43,-1,1
320,CLE,Cleveland Cavaliers,2003,186.5,0.365050813,68.08197663,17,36,-19,19
321,HOU,Houston Rockets,2003,184.2,0.69117378,127.3142104,43,44,-1,1
322,UTA,Utah Jazz,2003,181.5,0.677103659,122.894314,47,44,3,3
323,MIA,Miami Heat,2003,178.5,0.551631098,98.46615091,25,40,-15,15
324,MEM,Memphis Grizzlies,2003,177.4,0.643770325,114.2048557,28,43,-15,15
325,MIL,Milwaukee Bucks,2003,173.7,0.621036585,107.8740549,42,42,0,0
326,GSW,Golden State Warriors,2003,172.3,0.85703252,147.6667033,38,47,-9,9
327,DEN,Denver Nuggets,2003,168.0,0.099039634,16.63865854,17,29,-12,12
328,NJN,New Jersey Nets,2003,165.0,0.791001016,130.5151677,49,45,4,4
329,NYK,New York Knicks,2003,154.3,0.822215447,126.8678435,37,44,-7,7
330,DAL,Dallas Mavericks,2003,154.1,0.623577236,96.09325203,60,40,20,20
331,BOS,Boston Celtics,2003,144.7,0.570823171,82.5981128,44,38,6,6
332,IND,Indiana Pacers,2003,143.9,0.72515752,104.3501672,48,41,7,7
333,PHO,Phoenix Suns,2003,137.8,0.651900407,89.83187602,44,39,5,5
334,CHI,Chicago Bulls,2003,119.0,0.504186992,59.99825203,30,35,-5,5
335,TOR,Toronto Raptors,2004,220.0,0.358689024,78.91158537,33,37,-4,4
336,DAL,Dallas Mavericks,2004,215.0,0.574913618,123.6064278,52,44,8,8
337,IND,Indiana Pacers,2004,208.7,0.739654472,154.3658882,61,48,13,13
338,WAS,Washington Wizards,2004,206.5,0.62238313,128.5221164,25,45,-20,20
339,POR,Portland Trail Blazers,2004,205.0,0.480106707,98.421875,41,40,1,1
340,LAC,Los Angeles Clippers,2004,200.2,0.480376016,96.17127846,28,40,-12,12
341,GSW,Golden State Warriors,2004,195.5,0.522235772,102.0970935,37,41,-4,4
342,SAC,Sacramento Kings,2004,192.1,0.723831301,139.0479929,55,46,9,9
343,MIN,Minnesota Timberwolves,2004,191.7,0.456285569,87.4699436,58,39,19,19
344,CHI,Chicago Bulls,2004,188.6,0.384126016,72.44616667,23,37,-14,14
345,DET,Detroit Pistons,2004,179.0,0.594674797,106.4467886,54,41,13,13
346,NOH,New Orleans Hornets,2004,177.5,0.825995935,146.6142785,41,47,-6,6
347,LAL,Los Angeles Lakers,2004,175.9,0.714029472,125.597784,56,44,12,12
348,HOU,Houston Rockets,2004,173.2,0.581737805,100.7569878,45,41,4,4
349,UTA,Utah Jazz,2004,171.8,0.376443089,64.67292276,42,35,7,7
350,MEM,Memphis Grizzlies,2004,167.8,0.639044715,107.2317033,50,42,8,8
351,NYK,New York Knicks,2004,164.6,0.47925813,78.88588821,39,37,2,2
352,SAS,San Antonio Spurs,2004,164.1,0.646498984,106.0904832,57,41,16,16
353,ORL,Orlando Magic,2004,162.9,0.371382114,60.49814634,21,35,-14,14
354,MIA,Miami Heat,2004,160.9,0.564933943,90.89787144,42,39,3,3
355,PHO,Phoenix Suns,2004,160.6,0.522611789,83.93145325,29,38,-9,9
356,ATL,Atlanta Hawks,2004,158.8,0.234166667,37.18566667,28,32,-4,4
357,PHI,Philadelphia 76ers,2004,157.7,0.646859756,102.0097835,33,41,-8,8
358,DEN,Denver Nuggets,2004,151.0,0.394161585,59.51839939,43,35,8,8
359,CLE,Cleveland Cavaliers,2004,149.0,0.346026423,51.55793699,35,34,1,1
360,NJN,New Jersey Nets,2004,148.9,0.929507114,138.4036092,47,46,1,1
361,MIL,Milwaukee Bucks,2004,143.9,0.264918699,38.12180081,41,32,9,9
362,BOS,Boston Celtics,2004,129.9,0.25652439,33.32251829,36,31,5,5
363,SEA,Seattle SuperSonics,2004,109.1,0.558445122,60.9263628,37,35,2,2
364,SEA,Seattle SuperSonics,2005,217.2,0.79898374,173.5392683,52,51,1,1
365,LAL,Los Angeles Lakers,2005,208.8,0.355965447,74.32558537,34,37,-3,3
366,GSW,Golden State Warriors,2005,201.5,0.470772358,94.86063008,34,40,-6,6
367,DAL,Dallas Mavericks,2005,199.9,0.462357724,92.42530894,58,39,19,19
368,MIN,Minnesota Timberwolves,2005,199.0,0.890442073,177.1979726,44,51,-7,7
369,IND,Indiana Pacers,2005,197.0,0.824202236,162.3678404,44,49,-5,5
370,SAC,Sacramento Kings,2005,189.3,0.560208333,106.0474375,50,41,9,9
371,PHI,Philadelphia 76ers,2005,180.6,0.518379065,93.61925915,43,40,3,3
372,SAS,San Antonio Spurs,2005,178.9,0.724639228,129.6379578,59,45,14,14
373,WAS,Washington Wizards,2005,172.5,0.842906504,145.401372,45,47,-2,2
374,HOU,Houston Rockets,2005,171.7,0.164369919,28.22231504,51,30,21,21
375,MIA,Miami Heat,2005,170.5,0.385843496,65.78631606,59,36,23,23
376,UTA,Utah Jazz,2005,169.6,0.499171748,84.65952846,26,38,-12,12
377,NJN,New Jersey Nets,2005,169.5,0.467860772,79.30240091,42,38,4,4
378,MIL,Milwaukee Bucks,2005,165.8,0.602962398,99.97116565,30,40,-10,10
379,DEN,Denver Nuggets,2005,165.6,0.78585874,130.1382073,49,45,4,4
380,LAC,Los Angeles Clippers,2005,164.6,0.590309959,97.16501931,37,40,-3,3
381,MEM,Memphis Grizzlies,2005,164.6,0.828465447,136.3654126,45,46,-1,1
382,NOH,New Orleans Hornets,2005,154.7,0.414751016,64.16198222,18,35,-17,17
383,POR,Portland Trail Blazers,2005,152.7,0.491128049,74.99525305,27,37,-10,10
384,BOS,Boston Celtics,2005,147.5,0.368231707,54.31417683,45,34,11,11
385,ORL,Orlando Magic,2005,146.4,0.062809959,9.195378049,36,28,8,8
386,DET,Detroit Pistons,2005,142.4,0.63960874,91.08028455,54,39,15,15
387,CHI,Chicago Bulls,2005,129.8,0.286565041,37.19614228,47,32,15,15
388,ATL,Atlanta Hawks,2005,110.6,0.125447154,13.87445528,13,28,-15,15
389,CLE,Cleveland Cavaliers,2005,110.4,0.42379065,46.7864878,42,33,9,9
390,PHO,Phoenix Suns,2005,107.7,0.593003049,63.86642835,62,35,27,27
391,NYK,New York Knicks,2005,101.7,0.246321138,25.05085976,33,30,3,3
392,TOR,Toronto Raptors,2005,98.00000000000001,0.324618902,31.81265244,33,31,2,2
393,NYK,New York Knicks,2006,231.4,0.349009146,80.76071646,23,38,-15,15
394,IND,Indiana Pacers,2006,226.0,0.75273374,170.1178252,41,50,-9,9
395,SAS,San Antonio Spurs,2006,202.6,0.816671748,165.4576961,63,50,13,13
396,POR,Portland Trail Blazers,2006,202.1,0.489745935,98.97765346,21,40,-19,19
397,MEM,Memphis Grizzlies,2006,198.8,0.582317073,115.7646341,49,43,6,6
398,LAL,Los Angeles Lakers,2006,197.3,0.501148374,98.87657419,45,40,5,5
399,WAS,Washington Wizards,2006,194.6,0.68859248,134.0000965,42,45,-3,3
400,MIN,Minnesota Timberwolves,2006,193.8,0.495609756,96.04917073,33,40,-7,7
401,UTA,Utah Jazz,2006,193.3,0.654441057,126.5034563,41,44,-3,3
402,NJN,New Jersey Nets,2006,186.7,0.519796748,97.04605285,49,40,9,9
403,LAC,Los Angeles Clippers,2006,186.6,0.53183435,99.24028963,47,40,7,7
404,SEA,Seattle SuperSonics,2006,180.8,0.581072154,105.0578455,35,41,-6,6
405,DEN,Denver Nuggets,2006,176.7,0.912210366,161.1875716,44,49,-5,5
406,CLE,Cleveland Cavaliers,2006,176.3,0.710574187,125.2742292,50,44,6,6
407,CHI,Chicago Bulls,2006,172.5,0.777484756,134.1161204,41,45,-4,4
408,ORL,Orlando Magic,2006,172.5,0.67796748,116.9493902,36,43,-7,7
409,MIA,Miami Heat,2006,170.3,0.47441565,80.79298526,52,38,14,14
410,TOR,Toronto Raptors,2006,169.0,0.44585874,75.35012703,27,37,-10,10
411,PHO,Phoenix Suns,2006,168.8,0.49254065,83.14086179,54,38,16,16
412,ATL,Atlanta Hawks,2006,165.4,0.417306911,69.02256301,26,36,-10,10
413,BOS,Boston Celtics,2006,162.5,0.433272358,70.40675813,33,36,-3,3
414,MIL,Milwaukee Bucks,2006,154.1,0.520807927,80.25650152,40,38,2,2
415,DET,Detroit Pistons,2006,153.9,0.893816057,137.5582912,64,46,18,18
416,DAL,Dallas Mavericks,2006,150.1,0.698363821,104.8244096,60,41,19,19
417,HOU,Houston Rockets,2006,142.6,0.461189024,65.76555488,34,36,-2,2
418,PHI,Philadelphia 76ers,2006,135.3,0.636636179,86.136875,38,39,-1,1
419,SAC,Sacramento Kings,2006,134.5,0.286143293,38.48627287,44,32,12,12
420,GSW,Golden State Warriors,2006,128.0,0.72449187,92.73495935,34,39,-5,5
421,DAL,Dallas Mavericks,2007,212.5,0.725721545,154.2158283,67,48,19,19
422,SAS,San Antonio Spurs,2007,206.4,0.793998984,163.8813902,58,50,8,8
423,PHO,Phoenix Suns,2007,190.6,0.867047764,165.2593039,61,50,11,11
424,MIA,Miami Heat,2007,189.8,0.935889228,177.6317754,44,51,-7,7
425,GSW,Golden State Warriors,2007,187.7,0.495060976,92.92294512,42,39,3,3
426,UTA,Utah Jazz,2007,186.8,0.696539634,130.1136037,51,45,6,6
427,MEM,Memphis Grizzlies,2007,186.7,0.433577236,80.94886992,22,38,-16,16
428,LAL,Los Angeles Lakers,2007,183.9,0.822911585,151.3334405,42,48,-6,6
429,IND,Indiana Pacers,2007,183.4,0.370813008,68.00710569,35,36,-1,1
430,WAS,Washington Wizards,2007,179.6,0.867784553,155.8541057,41,48,-7,7
431,CHI,Chicago Bulls,2007,178.0,0.729507114,129.8522663,49,45,4,4
432,DET,Detroit Pistons,2007,177.9,0.742647358,132.1169649,53,45,8,8
433,MIL,Milwaukee Bucks,2007,177.1,0.46609248,82.54497815,28,38,-10,10
434,CLE,Cleveland Cavaliers,2007,173.7,0.891112805,154.7862942,50,48,2,2
435,ATL,Atlanta Hawks,2007,171.6,0.838114837,143.8205061,30,47,-17,17
436,PHI,Philadelphia 76ers,2007,171.1,0.537372967,91.94451474,35,39,-4,4
437,NOK,New Orleans/Oklahoma City Hornets,2007,169.4,0.486305894,82.3802185,39,38,1,1
438,LAC,Los Angeles Clippers,2007,168.9,0.869984756,146.9404253,40,47,-7,7
439,ORL,Orlando Magic,2007,165.3,0.656514228,108.5218018,40,42,-2,2
440,NYK,New York Knicks,2007,164.9,0.70226626,115.8037063,33,43,-10,10
441,SAC,Sacramento Kings,2007,159.4,0.714989837,113.9693801,33,42,-9,9
442,HOU,Houston Rockets,2007,158.9,0.63867378,101.4852637,52,41,11,11
443,POR,Portland Trail Blazers,2007,154.2,0.394085366,60.76796341,32,35,-3,3
444,BOS,Boston Celtics,2007,152.0,0.587718496,89.33321138,24,39,-15,15
445,TOR,Toronto Raptors,2007,149.9,0.50245935,75.3186565,47,37,10,10
446,NJN,New Jersey Nets,2007,142.3,0.789786585,112.3866311,41,42,-1,1
447,SEA,Seattle SuperSonics,2007,133.5,0.663180894,88.53464939,31,39,-8,8
448,MIN,Minnesota Timberwolves,2007,123.4,0.604344512,74.5761128,32,37,-5,5
449,DEN,Denver Nuggets,2007,114.2,0.469456301,53.61190955,45,34,11,11
450,TOR,Toronto Raptors,2008,207.5,0.832652439,172.7753811,41,51,-10,10
451,MEM,Memphis Grizzlies,2008,207.1,0.429105691,88.86778862,22,39,-17,17
452,SAS,San Antonio Spurs,2008,203.3,0.869227642,176.7139797,56,51,5,5
453,DET,Detroit Pistons,2008,202.1,0.724603659,146.4423994,59,47,12,12
454,ATL,Atlanta Hawks,2008,200.4,0.657347561,131.7324512,37,45,-8,8
455,ORL,Orlando Magic,2008,199.0,0.646382114,128.6300407,52,45,7,7
456,BOS,Boston Celtics,2008,198.2,0.391168699,77.52963618,66,37,29,29
457,MIA,Miami Heat,2008,197.4,0.495746951,97.86044817,15,40,-25,25
458,WAS,Washington Wizards,2008,196.0,0.806534553,158.0807724,43,49,-6,6
459,LAL,Los Angeles Lakers,2008,191.8,0.671316057,128.7584197,57,45,12,12
460,DAL,Dallas Mavericks,2008,190.8,0.667123984,127.2872561,51,44,7,7
461,PHO,Phoenix Suns,2008,184.9,0.674065041,124.634626,55,44,11,11
462,NYK,New York Knicks,2008,182.6,0.852652439,155.6943354,23,48,-25,25
463,SEA,Seattle SuperSonics,2008,182.3,0.719054878,131.0837043,20,45,-25,25
464,CHI,Chicago Bulls,2008,178.7,0.710909553,127.0395371,33,44,-11,11
465,CLE,Cleveland Cavaliers,2008,178.1,0.655528455,116.7496179,45,43,2,2
466,HOU,Houston Rockets,2008,175.4,0.792566057,139.0160864,55,46,9,9
467,POR,Portland Trail Blazers,2008,172.9,0.573069106,99.08364837,41,40,1,1
468,UTA,Utah Jazz,2008,163.2,0.794126016,129.6013659,54,45,9,9
469,MIN,Minnesota Timberwolves,2008,162.8,0.304400407,49.55638618,22,33,-11,11
470,PHI,Philadelphia 76ers,2008,156.2,0.527977642,82.47010772,40,38,2,2
471,GSW,Golden State Warriors,2008,154.7,0.598724593,92.62269461,48,39,9,9
472,SAC,Sacramento Kings,2008,149.5,0.740025407,110.6337983,38,42,-4,4
473,MIL,Milwaukee Bucks,2008,146.5,0.58120935,85.14716972,26,38,-12,12
474,DEN,Denver Nuggets,2008,144.1,0.632743902,91.17839634,50,39,11,11
475,LAC,Los Angeles Clippers,2008,141.8,0.746285569,105.8232937,23,41,-18,18
476,IND,Indiana Pacers,2008,131.2,0.547662602,71.85333333,36,36,0,0
477,NJN,New Jersey Nets,2008,123.7,0.480050813,59.38228557,34,35,-1,1
478,SAS,San Antonio Spurs,2009,219.5,0.856732724,188.0528328,54,53,1,1
479,GSW,Golden State Warriors,2009,217.4,0.544588415,118.3935213,29,43,-14,14
480,HOU,Houston Rockets,2009,212.6,0.656824187,139.6408222,53,46,7,7
481,NYK,New York Knicks,2009,209.4000000000001,0.489364837,102.472997,32,41,-9,9
482,TOR,Toronto Raptors,2009,204.9,0.619507114,126.9370076,33,44,-11,11
483,IND,Indiana Pacers,2009,198.3,0.653109756,129.5116646,36,45,-9,9
484,LAC,Los Angeles Clippers,2009,191.5,0.362611789,69.44015752,19,36,-17,17
485,BOS,Boston Celtics,2009,190.4,0.876128049,166.8147805,62,50,12,12
486,MIA,Miami Heat,2009,185.8,0.491686992,91.35544309,43,39,4,4
487,MIL,Milwaukee Bucks,2009,181.0,0.501270325,90.72992886,34,39,-5,5
488,DET,Detroit Pistons,2009,180.7,0.728780488,131.6906341,39,45,-6,6
489,ORL,Orlando Magic,2009,175.7,0.582876016,102.4113161,59,41,18,18
490,NOH,New Orleans Hornets,2009,173.0,0.848424797,146.7774898,49,47,2,2
491,WAS,Washington Wizards,2009,172.7,0.812322154,140.2880361,19,46,-27,27
492,PHI,Philadelphia 76ers,2009,172.6,0.825436992,142.4704248,41,47,-6,6
493,LAL,Los Angeles Lakers,2009,171.4,0.728841463,124.9234268,65,44,21,21
494,POR,Portland Trail Blazers,2009,171.0,0.811417683,138.7524238,54,46,8,8
495,DEN,Denver Nuggets,2009,170.6,0.533318089,90.98406606,54,39,15,15
496,UTA,Utah Jazz,2009,170.3,0.901890244,153.5919085,48,48,0,0
497,PHO,Phoenix Suns,2009,156.5,0.515365854,80.6547561,46,38,8,8
498,SAC,Sacramento Kings,2009,150.5,0.386102642,58.10844766,17,35,-18,18
499,MIN,Minnesota Timberwolves,2009,147.4,0.612154472,90.23156911,24,39,-15,15
500,CHI,Chicago Bulls,2009,140.7,0.521864837,73.42638262,41,37,4,4
501,DAL,Dallas Mavericks,2009,135.6,0.717469512,97.28886585,50,40,10,10
502,MEM,Memphis Grizzlies,2009,135.1,0.39640752,53.554656,24,34,-10,10
503,ATL,Atlanta Hawks,2009,128.5,0.698658537,89.77762195,47,39,8,8
504,CLE,Cleveland Cavaliers,2009,121.1,0.483775407,58.58520173,66,35,31,31
505,NJN,New Jersey Nets,2009,105.5,0.305127033,32.19090193,34,31,3,3
506,SAS,San Antonio Spurs,2010,253.6,0.610137195,154.7307927,50,48,2,2
507,OKC,Oklahoma City Thunder,2010,233.0,0.64476626,150.2305386,50,48,2,2
508,GSW,Golden State Warriors,2010,206.3999999999999,0.657566057,135.7216341,26,46,-20,20
509,UTA,Utah Jazz,2010,202.8,0.771448171,156.449689,53,48,5,5
510,BOS,Boston Celtics,2010,200.7,0.792698171,159.0945229,50,49,1,1
511,IND,Indiana Pacers,2010,195.7,0.639009146,125.0540899,32,44,-12,12
512,POR,Portland Trail Blazers,2010,186.5,0.674918699,125.8723374,50,44,6,6
513,HOU,Houston Rockets,2010,186.1,0.37488313,69.76575051,42,36,6,6
514,WAS,Washington Wizards,2010,183.8,0.241046748,44.30439228,26,33,-7,7
515,MIL,Milwaukee Bucks,2010,182.3,0.467311992,85.19097612,46,38,8,8
516,PHI,Philadelphia 76ers,2010,179.8,0.702184959,126.2528557,27,44,-17,17
517,ATL,Atlanta Hawks,2010,178.3,0.832520325,148.438374,53,47,6,6
518,CLE,Cleveland Cavaliers,2010,178.1,0.743643293,132.4428704,61,45,16,16
519,DAL,Dallas Mavericks,2010,176.1,0.603394309,106.2577378,55,41,14,14
520,NJN,New Jersey Nets,2010,171.1,0.766636179,131.1714502,12,45,-33,33
521,LAL,Los Angeles Lakers,2010,169.8,0.848328252,144.0461372,57,47,10,10
522,NOH,New Orleans Hornets,2010,166.7,0.626732724,104.476345,37,41,-4,4
523,LAC,Los Angeles Clippers,2010,161.9,0.477860772,77.36565904,29,37,-8,8
524,DET,Detroit Pistons,2010,161.5,0.562489837,90.84210874,27,39,-12,12
525,MEM,Memphis Grizzlies,2010,158.8,0.644095528,102.2823699,40,41,-1,1
526,PHO,Phoenix Suns,2010,157.0,0.557296748,87.49558943,54,39,15,15
527,MIN,Minnesota Timberwolves,2010,153.6,0.392093496,60.22556098,15,35,-20,20
528,ORL,Orlando Magic,2010,151.8,0.594832317,90.29554573,59,39,20,20
529,MIA,Miami Heat,2010,144.3,0.781575203,112.7813018,47,42,5,5
530,DEN,Denver Nuggets,2010,132.2,0.669247967,88.4745813,53,39,14,14
531,NYK,New York Knicks,2010,123.5,0.452057927,55.82915396,29,34,-5,5
532,CHI,Chicago Bulls,2010,113.4,0.416986789,47.28630183,41,33,8,8
533,TOR,Toronto Raptors,2010,107.7,0.391646341,42.18031098,40,32,8,8
534,SAC,Sacramento Kings,2010,98.89999999999999,0.487550813,48.21877541,25,33,-8,8
535,OKC,Oklahoma City Thunder,2011,210.3,0.664283537,139.6988277,55,46,9,9
536,TOR,Toronto Raptors,2011,202.5,0.490416667,99.309375,22,40,-18,18
537,SAS,San Antonio Spurs,2011,202.2,0.782210366,158.162936,61,49,12,12
538,MEM,Memphis Grizzlies,2011,198.2,0.833470528,165.1938587,46,50,-4,4
539,POR,Portland Trail Blazers,2011,197.4,0.520223577,102.6921341,48,41,7,7
540,GSW,Golden State Warriors,2011,196.3,0.360279472,70.72286026,36,36,0,0
541,UTA,Utah Jazz,2011,188.0,0.448064024,84.23603659,39,38,1,1
542,CLE,Cleveland Cavaliers,2011,186.3,0.404502033,75.35872866,19,37,-18,18
543,IND,Indiana Pacers,2011,186.2,0.721463415,134.3364878,37,45,-8,8
544,ORL,Orlando Magic,2011,184.9,0.41015752,75.83812551,52,37,15,15
545,ATL,Atlanta Hawks,2011,184.6,0.785071138,144.9241321,44,47,-3,3
546,PHO,Phoenix Suns,2011,183.0,0.520868902,95.31900915,40,40,0,0
547,DET,Detroit Pistons,2011,182.5,0.825660569,150.6830539,30,48,-18,18
548,DEN,Denver Nuggets,2011,176.9,0.612820122,108.4078796,50,42,8,8
549,LAL,Los Angeles Lakers,2011,173.8,0.843465447,146.5942947,57,47,10,10
550,BOS,Boston Celtics,2011,165.8,0.616377033,102.195312,56,41,15,15
551,WAS,Washington Wizards,2011,164.7,0.236112805,38.88777896,23,32,-9,9
552,SAC,Sacramento Kings,2011,159.3,0.591875,94.2856875,24,40,-16,16
553,MIA,Miami Heat,2011,159.2,0.455574187,72.52741057,58,37,21,21
554,MIN,Minnesota Timberwolves,2011,157.2,0.276427846,43.45445732,17,32,-15,15
555,MIL,Milwaukee Bucks,2011,157.0,0.58117378,91.24428354,35,39,-4,4
556,PHI,Philadelphia 76ers,2011,156.9,0.675848577,106.0406418,41,41,0,0
557,NJN,New Jersey Nets,2011,156.3,0.15375,24.031125,24,30,-6,6
558,NOH,New Orleans Hornets,2011,155.8,0.357123984,55.63991667,46,34,12,12
559,DAL,Dallas Mavericks,2011,138.8,0.665035569,92.30693699,57,39,18,18
560,HOU,Houston Rockets,2011,122.4,0.385376016,47.17002439,43,33,10,10
561,LAC,Los Angeles Clippers,2011,121.1,0.365995935,44.32210772,32,33,-1,1
562,CHI,Chicago Bulls,2011,117.3,0.490630081,57.55090854,62,34,28,28
563,NYK,New York Knicks,2011,116.7,0.055203252,6.442219512,42,27,15,15
593,SAS,San Antonio Spurs,2013,248.1,0.658343496,163.3350213,58,49,9,9
594,NOH,New Orleans Hornets,2013,240.1,0.296204268,71.11864482,27,36,-9,9
595,NYK,New York Knicks,2013,217.3,0.465813008,101.2211667,54,41,13,13
596,CHI,Chicago Bulls,2013,215.1,0.424776423,91.36940854,45,39,6,6
597,DEN,Denver Nuggets,2013,214.9,0.494502033,106.2684868,57,41,16,16
598,IND,Indiana Pacers,2013,210.8,0.566554878,119.4297683,49,43,6,6
599,OKC,Oklahoma City Thunder,2013,201.4,0.56574187,113.9404126,60,42,18,18
600,ATL,Atlanta Hawks,2013,201.1,0.377977642,76.01130386,44,37,7,7
601,MIN,Minnesota Timberwolves,2013,198.1,0.470320122,93.17041616,31,40,-9,9
602,GSW,Golden State Warriors,2013,194.1,0.351519309,68.22989787,47,36,11,11
603,LAC,Los Angeles Clippers,2013,190.4,0.473145325,90.08686992,56,39,17,17
604,DAL,Dallas Mavericks,2013,189.0,0.393704268,74.41010671,41,37,4,4
605,UTA,Utah Jazz,2013,185.6,0.565696138,104.9932033,43,41,2,2
606,MIL,Milwaukee Bucks,2013,185.0,0.434695122,80.41859756,38,38,0,0
607,PHO,Phoenix Suns,2013,184.7,0.343511179,63.44651474,25,35,-10,10
608,TOR,Toronto Raptors,2013,184.1,0.362042683,66.65205793,34,36,-2,2
609,BOS,Boston Celtics,2013,183.5,0.488678862,89.67257114,41,39,2,2
610,DET,Detroit Pistons,2013,179.8,0.48191565,86.64843394,29,39,-10,10
611,PHI,Philadelphia 76ers,2013,178.4,0.366626016,65.4060813,34,36,-2,2
612,SAC,Sacramento Kings,2013,176.9,0.671656504,118.8160356,28,43,-15,15
613,HOU,Houston Rockets,2013,175.5,0.095050813,16.68141768,45,29,16,16
614,MIA,Miami Heat,2013,173.1,0.766946138,132.7583765,66,45,21,21
615,WAS,Washington Wizards,2013,171.4,0.392474593,67.27014533,29,36,-7,7
616,MEM,Memphis Grizzlies,2013,170.3,0.409212398,69.68887144,56,36,20,20
617,ORL,Orlando Magic,2013,168.4,0.243155488,40.94738415,20,32,-12,12
618,CLE,Cleveland Cavaliers,2013,164.2,0.440635163,72.3522937,24,37,-13,13
619,POR,Portland Trail Blazers,2013,150.2,0.360675813,54.17350711,33,34,-1,1
620,LAL,Los Angeles Lakers,2013,146.5,0.437276423,64.06099593,45,35,10,10
621,DEN,Denver Nuggets,2014,229.1,0.427652439,97.97517378,36,40,-4,4
622,DAL,Dallas Mavericks,2014,221.7,0.442860772,98.18223323,49,40,9,9
623,NYK,New York Knicks,2014,221.5,0.660853659,146.3790854,37,47,-10,10
624,SAS,San Antonio Spurs,2014,220.9,0.785426829,173.5007866,62,51,11,11
625,MIN,Minnesota Timberwolves,2014,214.7,0.525177846,112.7556834,40,42,-2,2
626,MIA,Miami Heat,2014,211.0,0.928572154,195.9287246,54,54,0,0
627,LAC,Los Angeles Clippers,2014,195.7,0.664827236,130.10669,57,45,12,12
628,BRK,Brooklyn Nets,2014,195.6,0.508526423,99.46776829,44,40,4,4
629,OKC,Oklahoma City Thunder,2014,190.4,0.834740854,158.9346585,59,49,10,10
630,UTA,Utah Jazz,2014,190.3,0.471122967,89.65470071,25,39,-14,14
631,ATL,Atlanta Hawks,2014,184.3,0.51015752,94.022031,38,40,-2,2
632,IND,Indiana Pacers,2014,182.8,0.706072154,129.0699898,56,45,11,11
633,BOS,Boston Celtics,2014,176.9,0.418424797,74.01934654,25,37,-12,12
634,DET,Detroit Pistons,2014,175.3,0.589674797,103.3699919,29,41,-12,12
635,PHI,Philadelphia 76ers,2014,170.1,0.161082317,27.40010213,19,30,-11,11
636,LAL,Los Angeles Lakers,2014,169.6,0.437662602,74.22757724,27,37,-10,10
637,GSW,Golden State Warriors,2014,169.0,0.646626016,109.2797967,51,42,9,9
638,WAS,Washington Wizards,2014,165.6,0.679329268,112.4969268,44,42,2,2
639,PHO,Phoenix Suns,2014,162.0,0.321549797,52.09106707,48,34,14,14
640,TOR,Toronto Raptors,2014,161.5,0.564623984,91.18677337,48,39,9,9
641,MIL,Milwaukee Bucks,2014,161.0,0.309613821,49.8478252,15,33,-18,18
642,CLE,Cleveland Cavaliers,2014,160.2,0.671265244,107.5366921,33,42,-9,9
643,POR,Portland Trail Blazers,2014,155.7,0.739715447,115.1736951,54,43,11,11
644,CHI,Chicago Bulls,2014,152.2,0.559837398,85.20725203,48,38,10,10
645,SAC,Sacramento Kings,2014,147.3,0.363058943,53.47858232,28,34,-6,6
646,HOU,Houston Rockets,2014,142.1,0.685228659,97.37099238,54,40,14,14
647,MEM,Memphis Grizzlies,2014,136.5,0.585416667,79.909375,50,38,12,12
648,ORL,Orlando Magic,2014,136.4,0.629273374,85.83288821,23,38,-15,15
649,MIA,Miami Heat,2015,336.2,0.475635163,159.9085417,37,49,-12,12
650,NOP,New Orleans Pelicans,2015,229.1,0.569776423,130.5357785,45,45,0,0
651,DAL,Dallas Mavericks,2015,216.4,0.336626016,72.84586992,50,37,13,13
652,LAL,Los Angeles Lakers,2015,212.8,0.459273374,97.73337398,21,40,-19,19
653,HOU,Houston Rockets,2015,210.1,0.560599593,117.7819746,56,43,13,13
654,MIL,Milwaukee Bucks,2015,209.8,0.55613313,116.6767307,41,43,-2,2
655,SAS,San Antonio Spurs,2015,208.6,0.97273374,202.9122581,55,55,0,0
656,LAC,Los Angeles Clippers,2015,204.7,0.665934959,136.3168862,56,46,10,10
657,NYK,New York Knicks,2015,203.4,0.327134146,66.53908537,17,36,-19,19
658,BRK,Brooklyn Nets,2015,202.7,0.531829268,107.8017927,38,42,-4,4
659,ATL,Atlanta Hawks,2015,202.0,0.866712398,175.0759045,60,51,9,9
660,PHO,Phoenix Suns,2015,201.9,0.563292683,113.7287927,39,42,-3,3
661,MIN,Minnesota Timberwolves,2015,198.9,0.487611789,96.98598476,16,40,-24,24
662,DET,Detroit Pistons,2015,196.6,0.488714431,96.08125711,32,40,-8,8
663,POR,Portland Trail Blazers,2015,189.2,0.843236789,159.5404004,51,49,2,2
664,MEM,Memphis Grizzlies,2015,188.6,0.587362805,110.776625,55,42,13,13
665,WAS,Washington Wizards,2015,180.1,0.7075,127.42075,46,44,2,2
666,UTA,Utah Jazz,2015,179.3,0.56402439,101.1295732,38,41,-3,3
667,OKC,Oklahoma City Thunder,2015,165.7,0.632433943,104.7943044,45,41,4,4
668,DEN,Denver Nuggets,2015,163.7,0.601087398,98.39800711,30,40,-10,10
669,IND,Indiana Pacers,2015,161.7,0.758785569,122.6956265,38,44,-6,6
670,CHA,Charlotte Hornets,2015,161.6,0,0,33,26,7,7
671,BOS,Boston Celtics,2015,160.6,0.513582317,82.48132012,40,38,2,2
672,GSW,Golden State Warriors,2015,159.9,0.858252033,137.2345,67,46,21,21
673,ORL,Orlando Magic,2015,157.1,0.53140752,83.48412144,25,38,-13,13
674,CLE,Cleveland Cavaliers,2015,143.2,0.414903455,59.4141748,53,35,18,18
675,TOR,Toronto Raptors,2015,129.7,0.703368902,91.22694665,49,39,10,10
676,CHI,Chicago Bulls,2015,116.8,0.740513211,86.49194309,50,39,11,11
677,PHI,Philadelphia 76ers,2015,97.0,0.178058943,17.27171748,18,29,-11,11
678,SAC,Sacramento Kings,2015,91.3,0.387525407,35.38106961,29,31,-2,2
679,SAC,Sacramento Kings,2016,268.2,0.511895325,137.2903262,33,46,-13,13
680,GSW,Golden State Warriors,2016,231.9,0.919979675,213.3432866,73,57,16,16
681,SAS,San Antonio Spurs,2016,224.8,0.720894309,162.0570407,67,49,18,18
682,ATL,Atlanta Hawks,2016,213.0,0.75175813,160.1244817,48,49,-1,1
683,IND,Indiana Pacers,2016,212.2,0.496895325,105.441188,45,41,4,4
684,LAC,Los Angeles Clippers,2016,211.8,0.62226626,131.7959939,53,45,8,8
685,MEM,Memphis Grizzlies,2016,211.4,0.51886687,109.6884563,42,42,0,0
686,MIN,Minnesota Timberwolves,2016,209.7,0.479420732,100.5345274,29,41,-12,12
687,LAL,Los Angeles Lakers,2016,194.8,0.30796748,59.99206504,17,35,-18,18
688,TOR,Toronto Raptors,2016,194.6,0.62370935,121.3738394,56,44,12,12
689,MIA,Miami Heat,2016,190.9,0.456310976,87.10976524,48,39,9,9
690,NOP,New Orleans Pelicans,2016,190.1,0.80035061,152.1466509,30,48,-18,18
691,UTA,Utah Jazz,2016,188.5,0.785914634,148.1449085,40,47,-7,7
692,POR,Portland Trail Blazers,2016,187.1,0.347042683,64.93168598,44,36,8,8
693,BRK,Brooklyn Nets,2016,183.8,0.382794715,70.3576687,21,36,-15,15
694,DAL,Dallas Mavericks,2016,183.7,0.430569106,79.09554472,42,38,4,4
695,CHO,Charlotte Hornets,2016,182.9,0.46863313,85.71299949,48,38,10,10
696,ORL,Orlando Magic,2016,182.4,0.589202236,107.4704878,35,42,-7,7
697,CHI,Chicago Bulls,2016,179.4,0.922454268,165.4882957,42,50,-8,8
698,MIL,Milwaukee Bucks,2016,173.6,0.541976626,94.08714228,33,40,-7,7
699,OKC,Oklahoma City Thunder,2016,172.3,0.598953252,103.1996453,55,41,14,14
700,WAS,Washington Wizards,2016,170.1,0.62488313,106.2926204,41,41,0,0
701,CLE,Cleveland Cavaliers,2016,163.7,0.63492378,103.9370229,57,41,16,16
702,NYK,New York Knicks,2016,155.4,0.243993902,37.91665244,32,32,0,0
703,HOU,Houston Rockets,2016,153.4,0.686498984,105.3089441,41,41,0,0
704,DEN,Denver Nuggets,2016,147.7,0.334944106,49.47124441,33,33,0,0
705,DET,Detroit Pistons,2016,136.4,0.376539634,51.3600061,44,34,10,10
706,BOS,Boston Celtics,2016,130.8,0.586707317,76.74131707,48,37,11,11
707,PHI,Philadelphia 76ers,2016,119.1,0.422256098,50.29070122,10,33,-23,23
708,PHO,Phoenix Suns,2016,109.3,0.399207317,43.63335976,23,32,-9,9
709,SAS,San Antonio Spurs,2017,236.0,0.688455285,162.4754472,61,49,12,12
710,GSW,Golden State Warriors,2017,226.2,0.624527439,141.2681067,67,46,21,21
711,NYK,New York Knicks,2017,210.5,0.384329268,80.90131098,31,38,-7,7
712,CHO,Charlotte Hornets,2017,209.8,0.644441057,135.2037337,36,45,-9,9
713,IND,Indiana Pacers,2017,208.1,0.617982724,128.6022048,42,45,-3,3
714,DAL,Dallas Mavericks,2017,207.6,0.474751016,98.55831098,33,40,-7,7
715,BRK,Brooklyn Nets,2017,207.3,0.156244919,32.38957165,20,31,-11,11
716,HOU,Houston Rockets,2017,205.8,0.501839431,103.2785549,55,41,14,14
717,BOS,Boston Celtics,2017,205.6,0.752103659,154.6325122,53,48,5,5
718,TOR,Toronto Raptors,2017,203.4,0.675248984,137.3456433,51,46,5,5
719,NOP,New Orleans Pelicans,2017,202.8,0.406722561,82.48333537,34,38,-4,4
720,LAC,Los Angeles Clippers,2017,197.8,0.815340447,161.2743404,51,49,2,2
721,MEM,Memphis Grizzlies,2017,193.8,0.519476626,100.6745701,43,41,2,2
722,SAC,Sacramento Kings,2017,191.6,0.454065041,86.99886179,32,39,-7,7
723,PHO,Phoenix Suns,2017,191.5,0.549817073,105.2899695,24,41,-17,17
724,CHI,Chicago Bulls,2017,189.6000000000001,0.281590447,53.38954878,41,34,7,7
725,CLE,Cleveland Cavaliers,2017,188.9,0.74089939,139.9558948,51,46,5,5
726,OKC,Oklahoma City Thunder,2017,186.8,0.496666667,92.77733333,47,39,8,8
727,MIL,Milwaukee Bucks,2017,184.0,0.62796748,115.5460163,42,43,-1,1
728,UTA,Utah Jazz,2017,183.5,0.758836382,139.2464761,51,46,5,5
729,ATL,Atlanta Hawks,2017,182.1,0.563089431,102.5385854,43,41,2,2
730,LAL,Los Angeles Lakers,2017,181.7,0.576504065,104.7507886,26,41,-15,15
731,DET,Detroit Pistons,2017,178.5,0.735055894,131.2074771,37,45,-8,8
732,PHI,Philadelphia 76ers,2017,177.7,0.386727642,68.72150203,28,36,-8,8
733,WAS,Washington Wizards,2017,177.3,0.492987805,87.4067378,49,39,10,10
734,MIA,Miami Heat,2017,176.7,0.484944106,85.68962348,41,38,3,3
735,DEN,Denver Nuggets,2017,173.4,0.765147358,132.6765518,40,45,-5,5
736,POR,Portland Trail Blazers,2017,171.4,0.797987805,136.7751098,41,46,-5,5
737,MIN,Minnesota Timberwolves,2017,169.7,0.81925813,139.0281047,31,46,-15,15
738,ORL,Orlando Magic,2017,157.7,0.542845528,85.60673984,29,38,-9,9
739,GSW,Golden State Warriors,2018,231.5,0.896377033,207.511283,58,56,2,2
740,DEN,Denver Nuggets,2018,227.3,0.631234756,143.4796601,46,47,-1,1
741,SAS,San Antonio Spurs,2018,223.9,0.777906504,174.1732663,47,51,-4,4
742,BOS,Boston Celtics,2018,221.8,0.366107724,81.20269309,55,38,17,17
743,UTA,Utah Jazz,2018,217.3,0.412881098,89.7190625,48,39,9,9
744,PHO,Phoenix Suns,2018,208.4,0.668196138,139.2520752,21,46,-25,25
745,PHI,Philadelphia 76ers,2018,202.5,0.488536585,98.92865854,52,40,12,12
746,LAC,Los Angeles Clippers,2018,202.2,0.276122967,55.83206402,42,34,8,8
747,TOR,Toronto Raptors,2018,202.2,0.589761179,119.2497104,59,43,16,16
748,DET,Detroit Pistons,2018,195.9,0.49339939,96.65694055,39,40,-1,1
749,MIL,Milwaukee Bucks,2018,193.9,0.810564024,157.1683643,44,49,-5,5
750,IND,Indiana Pacers,2018,193.8,0.36953252,71.61540244,48,36,12,12
751,MEM,Memphis Grizzlies,2018,192.8,0.501651423,96.71839431,22,40,-18,18
752,CLE,Cleveland Cavaliers,2018,192.4,0.515264228,99.1368374,50,40,10,10
753,NYK,New York Knicks,2018,191.0,0.493257114,94.21210874,29,40,-11,11
754,WAS,Washington Wizards,2018,185.1,0.864151423,159.9544284,43,49,-6,6
755,MIN,Minnesota Timberwolves,2018,184.1,0.571031504,105.1268999,47,41,6,6
756,LAL,Los Angeles Lakers,2018,182.6,0.330203252,60.29511382,35,35,0,0
757,HOU,Houston Rockets,2018,182.2,0.665320122,121.2213262,65,43,22,22
758,MIA,Miami Heat,2018,181.9,0.859852642,156.4071956,44,48,-4,4
759,BRK,Brooklyn Nets,2018,177.3,0.406321138,72.0407378,28,37,-9,9
760,SAC,Sacramento Kings,2018,173.2,0.263058943,45.56180894,27,33,-6,6
761,NOP,New Orleans Pelicans,2018,172.9,0.494598577,85.516094,48,38,10,10
762,CHO,Charlotte Hornets,2018,170.7,0.762926829,130.2316098,36,45,-9,9
763,DAL,Dallas Mavericks,2018,167.5,0.57816565,96.84274644,24,40,-16,16
764,OKC,Oklahoma City Thunder,2018,167.0,0.465929878,77.81028963,48,37,11,11
765,POR,Portland Trail Blazers,2018,163.1,0.72363313,118.0245635,49,43,6,6
766,CHI,Chicago Bulls,2018,158.5,0.363597561,57.63021341,27,34,-7,7
767,ATL,Atlanta Hawks,2018,154.9,0.421305894,65.26028303,24,36,-12,12
768,ORL,Orlando Magic,2018,151.3,0.558023374,84.42893648,25,38,-13,13
